Año,Trimestre,Provincia,Banda ancha fija,Dial up,Total
2022-01-01,4,Buenos Aires,5,6,11
2022-01-01,4,Capital Federal,2,2,4
2022-01-01,4,Catamarca,71,1,72
2022-01-01,4,Chaco,144,5,149
2022-01-01,4,Chubut,168,904,1072
2022-01-01,4,Córdoba,1,68,69
2022-01-01,4,Corrientes,155,4,159
2022-01-01,4,Entre Ríos,271,22,293
2022-01-01,4,Formosa,62,0,62
2022-01-01,4,Jujuy,118,0,118
2022-01-01,4,La Pampa,114,171,285
2022-01-01,4,La Rioja,86,4,90
2022-01-01,4,Mendoza,291,777,1068
2022-01-01,4,Misiones,186,0,186
2022-01-01,4,Neuquén,160,468,628
2022-01-01,4,Río Negro,162,548,710
2022-01-01,4,Salta,206,5,211
2022-01-01,4,San Juan,104,281,385
2022-01-01,4,San Luis,135,192,327
2022-01-01,4,Santa Cruz,50,198,248
2022-01-01,4,Santa Fe,888,110,998
2022-01-01,4,Santiago Del Estero,119,2,121
2022-01-01,4,Tierra Del Fuego,55,312,367
2022-01-01,4,Tucumán,263,30,293
2022-01-01,3,Buenos Aires,5,6,11
2022-01-01,3,Capital Federal,2,2,4
2022-01-01,3,Catamarca,70,1,71
2022-01-01,3,Chaco,144,5,149
2022-01-01,3,Chubut,165,904,1069
2022-01-01,3,Córdoba,1,68,69
2022-01-01,3,Corrientes,145,4,149
2022-01-01,3,Entre Ríos,269,22,291
2022-01-01,3,Formosa,69,1,70
2022-01-01,3,Jujuy,119,0,119
2022-01-01,3,La Pampa,116,171,287
2022-01-01,3,La Rioja,87,4,91
2022-01-01,3,Mendoza,289,777,1066
2022-01-01,3,Misiones,182,0,182
2022-01-01,3,Neuquén,163,468,631
2022-01-01,3,Río Negro,160,548,708
2022-01-01,3,Salta,205,5,210
2022-01-01,3,San Juan,103,281,384
2022-01-01,3,San Luis,122,182,304
2022-01-01,3,Santa Cruz,49,198,247
2022-01-01,3,Santa Fe,888,110,998
2022-01-01,3,Santiago Del Estero,119,2,121
2022-01-01,3,Tierra Del Fuego,54,312,366
2022-01-01,3,Tucumán,263,30,293
2022-01-01,2,Buenos Aires,5,6,11
2022-01-01,2,Capital Federal,2,2,4
2022-01-01,2,Catamarca,67,1,68
2022-01-01,2,Chaco,144,5,149
2022-01-01,2,Chubut,162,904,1066
2022-01-01,2,Córdoba,1,68,69
2022-01-01,2,Corrientes,145,4,149
2022-01-01,2,Entre Ríos,269,22,291
2022-01-01,2,Formosa,68,0,68
2022-01-01,2,Jujuy,115,0,115
2022-01-01,2,La Pampa,111,171,282
2022-01-01,2,La Rioja,86,4,90
2022-01-01,2,Mendoza,279,777,1056
2022-01-01,2,Misiones,179,0,179
2022-01-01,2,Neuquén,162,468,630
2022-01-01,2,Río Negro,159,548,707
2022-01-01,2,Salta,203,5,208
2022-01-01,2,San Juan,100,281,381
2022-01-01,2,San Luis,122,182,304
2022-01-01,2,Santa Cruz,49,198,247
2022-01-01,2,Santa Fe,879,110,989
2022-01-01,2,Santiago Del Estero,118,2,120
2022-01-01,2,Tierra Del Fuego,53,312,365
2022-01-01,2,Tucumán,254,30,284
2022-01-01,1,Buenos Aires,5,6,11
2022-01-01,1,Capital Federal,1,2,3
2022-01-01,1,Catamarca,62,1,63
2022-01-01,1,Chaco,144,5,149
2022-01-01,1,Chubut,171,927,1098
2022-01-01,1,Córdoba,1,74,75
2022-01-01,1,Corrientes,143,4,147
2022-01-01,1,Entre Ríos,268,22,290
2022-01-01,1,Formosa,55,0,55
2022-01-01,1,Jujuy,117,0,117
2022-01-01,1,La Pampa,110,172,282
2022-01-01,1,La Rioja,84,4,88
2022-01-01,1,Mendoza,274,786,1060
2022-01-01,1,Misiones,172,0,172
2022-01-01,1,Neuquén,149,471,620
2022-01-01,1,Río Negro,157,553,710
2022-01-01,1,Salta,198,5,203
2022-01-01,1,San Juan,88,290,378
2022-01-01,1,San Luis,120,185,305
2022-01-01,1,Santa Cruz,49,204,253
2022-01-01,1,Santa Fe,870,115,985
2022-01-01,1,Santiago Del Estero,116,2,118
2022-01-01,1,Tierra Del Fuego,52,313,365
2022-01-01,1,Tucumán,246,30,276
2021-01-01,4,Buenos Aires,5,6,11
2021-01-01,4,Capital Federal,1,2,3
2021-01-01,4,Catamarca,59,1,60
2021-01-01,4,Chaco,144,5,149
2021-01-01,4,Chubut,159,944,1103
2021-01-01,4,Córdoba,987,77,1064
2021-01-01,4,Corrientes,136,4,140
2021-01-01,4,Entre Ríos,265,22,287
2021-01-01,4,Formosa,54,0,54
2021-01-01,4,Jujuy,114,0,114
2021-01-01,4,La Pampa,107,173,280
2021-01-01,4,La Rioja,83,4,87
2021-01-01,4,Mendoza,267,804,1071
2021-01-01,4,Misiones,171,0,171
2021-01-01,4,Neuquén,147,477,624
2021-01-01,4,Río Negro,153,564,717
2021-01-01,4,Salta,199,6,205
2021-01-01,4,San Juan,80,291,371
2021-01-01,4,San Luis,119,187,306
2021-01-01,4,Santa Cruz,48,210,258
2021-01-01,4,Santa Fe,866,176,1042
2021-01-01,4,Santiago Del Estero,116,2,118
2021-01-01,4,Tierra Del Fuego,52,315,367
2021-01-01,4,Tucumán,239,30,269
2021-01-01,3,Buenos Aires,4,5,9
2021-01-01,3,Capital Federal,1,2,3
2021-01-01,3,Catamarca,56,1,57
2021-01-01,3,Chaco,140,3,143
2021-01-01,3,Chubut,155,800,955
2021-01-01,3,Córdoba,947,62,1009
2021-01-01,3,Corrientes,134,3,137
2021-01-01,3,Entre Ríos,260,15,275
2021-01-01,3,Formosa,53,0,53
2021-01-01,3,Jujuy,111,0,111
2021-01-01,3,La Pampa,100,116,216
2021-01-01,3,La Rioja,82,3,85
2021-01-01,3,Mendoza,255,619,874
2021-01-01,3,Misiones,159,0,159
2021-01-01,3,Neuquén,139,373,512
2021-01-01,3,Río Negro,144,501,645
2021-01-01,3,Salta,196,2,198
2021-01-01,3,San Juan,79,256,335
2021-01-01,3,San Luis,118,148,266
2021-01-01,3,Santa Cruz,49,197,246
2021-01-01,3,Santa Fe,841,151,992
2021-01-01,3,Santiago Del Estero,115,1,116
2021-01-01,3,Tierra Del Fuego,50,289,339
2021-01-01,3,Tucumán,232,25,257
2021-01-01,2,Buenos Aires,4,5,9
2021-01-01,2,Capital Federal,1,2,3
2021-01-01,2,Catamarca,56,1,57
2021-01-01,2,Chaco,141,3,144
2021-01-01,2,Chubut,138,825,963
2021-01-01,2,Córdoba,931,62,993
2021-01-01,2,Corrientes,129,3,132
2021-01-01,2,Entre Ríos,258,15,273
2021-01-01,2,Formosa,52,0,52
2021-01-01,2,Jujuy,112,0,112
2021-01-01,2,La Pampa,98,116,214
2021-01-01,2,La Rioja,82,3,85
2021-01-01,2,Mendoza,229,619,848
2021-01-01,2,Misiones,156,0,156
2021-01-01,2,Neuquén,138,373,511
2021-01-01,2,Río Negro,144,501,645
2021-01-01,2,Salta,192,2,194
2021-01-01,2,San Juan,79,256,335
2021-01-01,2,San Luis,123,148,271
2021-01-01,2,Santa Cruz,49,197,246
2021-01-01,2,Santa Fe,840,151,991
2021-01-01,2,Santiago Del Estero,114,1,115
2021-01-01,2,Tierra Del Fuego,35,289,324
2021-01-01,2,Tucumán,233,25,258
2021-01-01,1,Buenos Aires,4,5,9
2021-01-01,1,Capital Federal,1,1,2
2021-01-01,1,Catamarca,52,1,53
2021-01-01,1,Chaco,140,3,143
2021-01-01,1,Chubut,132,825,957
2021-01-01,1,Córdoba,911,55,966
2021-01-01,1,Corrientes,127,3,130
2021-01-01,1,Entre Ríos,252,13,265
2021-01-01,1,Formosa,51,0,51
2021-01-01,1,Jujuy,110,0,110
2021-01-01,1,La Pampa,97,116,213
2021-01-01,1,La Rioja,53,3,56
2021-01-01,1,Mendoza,218,615,833
2021-01-01,1,Misiones,149,0,149
2021-01-01,1,Neuquén,133,373,506
2021-01-01,1,Río Negro,141,501,642
2021-01-01,1,Salta,188,2,190
2021-01-01,1,San Juan,78,256,334
2021-01-01,1,San Luis,119,148,267
2021-01-01,1,Santa Cruz,46,197,243
2021-01-01,1,Santa Fe,826,137,963
2021-01-01,1,Santiago Del Estero,112,1,113
2021-01-01,1,Tierra Del Fuego,40,289,329
2021-01-01,1,Tucumán,232,22,254
2020-01-01,4,Buenos Aires,4,5,9
2020-01-01,4,Capital Federal,1,1,2
2020-01-01,4,Catamarca,52,1,53
2020-01-01,4,Chaco,139,3,142
2020-01-01,4,Chubut,130,825,955
2020-01-01,4,Córdoba,903,55,958
2020-01-01,4,Corrientes,126,3,129
2020-01-01,4,Entre Ríos,247,13,260
2020-01-01,4,Formosa,50,0,50
2020-01-01,4,Jujuy,106,0,106
2020-01-01,4,La Pampa,97,116,213
2020-01-01,4,La Rioja,53,3,56
2020-01-01,4,Mendoza,215,615,830
2020-01-01,4,Misiones,147,0,147
2020-01-01,4,Neuquén,133,373,506
2020-01-01,4,Río Negro,141,501,642
2020-01-01,4,Salta,187,2,189
2020-01-01,4,San Juan,72,256,328
2020-01-01,4,San Luis,119,148,267
2020-01-01,4,Santa Cruz,40,197,237
2020-01-01,4,Santa Fe,821,137,958
2020-01-01,4,Santiago Del Estero,107,1,108
2020-01-01,4,Tierra Del Fuego,39,289,328
2020-01-01,4,Tucumán,231,22,253
2020-01-01,3,Buenos Aires,4,5,9
2020-01-01,3,Capital Federal,1,1,2
2020-01-01,3,Catamarca,50,1,51
2020-01-01,3,Chaco,134,3,137
2020-01-01,3,Chubut,129,825,954
2020-01-01,3,Córdoba,867,55,922
2020-01-01,3,Corrientes,123,3,126
2020-01-01,3,Entre Ríos,241,13,254
2020-01-01,3,Formosa,49,0,49
2020-01-01,3,Jujuy,107,0,107
2020-01-01,3,La Pampa,94,116,210
2020-01-01,3,La Rioja,53,3,56
2020-01-01,3,Mendoza,207,615,822
2020-01-01,3,Misiones,143,0,143
2020-01-01,3,Neuquén,129,373,502
2020-01-01,3,Río Negro,131,501,632
2020-01-01,3,Salta,181,2,183
2020-01-01,3,San Juan,77,256,333
2020-01-01,3,San Luis,116,148,264
2020-01-01,3,Santa Cruz,39,197,236
2020-01-01,3,Santa Fe,803,137,940
2020-01-01,3,Santiago Del Estero,105,1,106
2020-01-01,3,Tierra Del Fuego,39,289,328
2020-01-01,3,Tucumán,224,22,246
2020-01-01,2,Buenos Aires,4,5,9
2020-01-01,2,Capital Federal,1,1,2
2020-01-01,2,Catamarca,48,1,49
2020-01-01,2,Chaco,128,3,131
2020-01-01,2,Chubut,108,825,933
2020-01-01,2,Córdoba,836,55,891
2020-01-01,2,Corrientes,119,3,122
2020-01-01,2,Entre Ríos,234,13,247
2020-01-01,2,Formosa,48,0,48
2020-01-01,2,Jujuy,94,0,94
2020-01-01,2,La Pampa,90,116,206
2020-01-01,2,La Rioja,52,3,55
2020-01-01,2,Mendoza,201,615,816
2020-01-01,2,Misiones,140,0,140
2020-01-01,2,Neuquén,126,373,499
2020-01-01,2,Río Negro,129,501,630
2020-01-01,2,Salta,178,2,180
2020-01-01,2,San Juan,70,256,326
2020-01-01,2,San Luis,114,148,262
2020-01-01,2,Santa Cruz,39,197,236
2020-01-01,2,Santa Fe,778,137,915
2020-01-01,2,Santiago Del Estero,105,1,106
2020-01-01,2,Tierra Del Fuego,39,289,328
2020-01-01,2,Tucumán,217,22,239
2020-01-01,1,Buenos Aires,4,5,9
2020-01-01,1,Capital Federal,1,1,2
2020-01-01,1,Catamarca,40,1,41
2020-01-01,1,Chaco,120,3,123
2020-01-01,1,Chubut,96,800,896
2020-01-01,1,Córdoba,811,55,866
2020-01-01,1,Corrientes,114,3,117
2020-01-01,1,Entre Ríos,232,13,245
2020-01-01,1,Formosa,46,0,46
2020-01-01,1,Jujuy,92,0,92
2020-01-01,1,La Pampa,89,116,205
2020-01-01,1,La Rioja,48,3,51
2020-01-01,1,Mendoza,183,615,798
2020-01-01,1,Misiones,134,0,134
2020-01-01,1,Neuquén,121,373,494
2020-01-01,1,Río Negro,126,501,627
2020-01-01,1,Salta,170,2,172
2020-01-01,1,San Juan,64,256,320
2020-01-01,1,San Luis,110,148,258
2020-01-01,1,Santa Cruz,39,197,236
2020-01-01,1,Santa Fe,771,137,908
2020-01-01,1,Santiago Del Estero,103,1,104
2020-01-01,1,Tierra Del Fuego,39,289,328
2020-01-01,1,Tucumán,200,22,222
2019-01-01,4,Buenos Aires,4,5,9
2019-01-01,4,Capital Federal,1,1,2
2019-01-01,4,Catamarca,38,1,39
2019-01-01,4,Chaco,118,3,121
2019-01-01,4,Chubut,95,810,905
2019-01-01,4,Córdoba,807,55,862
2019-01-01,4,Corrientes,114,3,117
2019-01-01,4,Entre Ríos,239,13,252
2019-01-01,4,Formosa,47,0,47
2019-01-01,4,Jujuy,89,0,89
2019-01-01,4,La Pampa,90,119,209
2019-01-01,4,La Rioja,49,3,52
2019-01-01,4,Mendoza,185,623,808
2019-01-01,4,Misiones,136,0,136
2019-01-01,4,Neuquén,116,376,492
2019-01-01,4,Río Negro,127,504,631
2019-01-01,4,Salta,172,2,174
2019-01-01,4,San Juan,65,259,324
2019-01-01,4,San Luis,108,148,256
2019-01-01,4,Santa Cruz,39,200,239
2019-01-01,4,Santa Fe,769,150,919
2019-01-01,4,Santiago Del Estero,104,1,105
2019-01-01,4,Tierra Del Fuego,40,291,331
2019-01-01,4,Tucumán,199,23,222
2019-01-01,3,Buenos Aires,4,10,14
2019-01-01,3,Capital Federal,1,3,4
2019-01-01,3,Catamarca,32,9,41
2019-01-01,3,Chaco,114,13,127
2019-01-01,3,Chubut,87,2,89
2019-01-01,3,Córdoba,783,107,890
2019-01-01,3,Corrientes,113,10,123
2019-01-01,3,Entre Ríos,238,45,283
2019-01-01,3,Formosa,46,0,46
2019-01-01,3,Jujuy,87,1,88
2019-01-01,3,La Pampa,91,269,360
2019-01-01,3,La Rioja,50,18,68
2019-01-01,3,Mendoza,223,1,224
2019-01-01,3,Misiones,134,0,134
2019-01-01,3,Neuquén,123,2,125
2019-01-01,3,Río Negro,143,904,1047
2019-01-01,3,Salta,152,1,153
2019-01-01,3,San Juan,73,563,636
2019-01-01,3,San Luis,122,291,413
2019-01-01,3,Santa Cruz,38,328,366
2019-01-01,3,Santa Fe,761,228,989
2019-01-01,3,Santiago Del Estero,133,2,135
2019-01-01,3,Tierra Del Fuego,48,544,592
2019-01-01,3,Tucumán,164,32,196
2019-01-01,2,Buenos Aires,4,10,14
2019-01-01,2,Capital Federal,1,3,4
2019-01-01,2,Catamarca,34,9,43
2019-01-01,2,Chaco,109,13,122
2019-01-01,2,Chubut,86,2,88
2019-01-01,2,Córdoba,775,105,880
2019-01-01,2,Corrientes,112,10,122
2019-01-01,2,Entre Ríos,236,44,280
2019-01-01,2,Formosa,46,0,46
2019-01-01,2,Jujuy,87,1,88
2019-01-01,2,La Pampa,90,268,358
2019-01-01,2,La Rioja,50,18,68
2019-01-01,2,Mendoza,223,1,224
2019-01-01,2,Misiones,133,0,133
2019-01-01,2,Neuquén,121,2,123
2019-01-01,2,Río Negro,138,915,1053
2019-01-01,2,Salta,143,1,144
2019-01-01,2,San Juan,69,564,633
2019-01-01,2,San Luis,117,291,408
2019-01-01,2,Santa Cruz,30,325,355
2019-01-01,2,Santa Fe,743,226,969
2019-01-01,2,Santiago Del Estero,127,2,129
2019-01-01,2,Tierra Del Fuego,47,544,591
2019-01-01,2,Tucumán,166,32,198
2019-01-01,1,Buenos Aires,4,10,14
2019-01-01,1,Capital Federal,1,3,4
2019-01-01,1,Catamarca,34,9,43
2019-01-01,1,Chaco,104,13,117
2019-01-01,1,Chubut,78,2,80
2019-01-01,1,Córdoba,744,105,849
2019-01-01,1,Corrientes,102,10,112
2019-01-01,1,Entre Ríos,232,44,276
2019-01-01,1,Formosa,45,0,45
2019-01-01,1,Jujuy,90,1,91
2019-01-01,1,La Pampa,89,268,357
2019-01-01,1,La Rioja,52,18,70
2019-01-01,1,Mendoza,205,1,206
2019-01-01,1,Misiones,123,0,123
2019-01-01,1,Neuquén,112,2,114
2019-01-01,1,Río Negro,120,915,1035
2019-01-01,1,Salta,136,1,137
2019-01-01,1,San Juan,62,564,626
2019-01-01,1,San Luis,96,291,387
2019-01-01,1,Santa Cruz,25,325,350
2019-01-01,1,Santa Fe,737,227,964
2019-01-01,1,Santiago Del Estero,90,2,92
2019-01-01,1,Tierra Del Fuego,46,544,590
2019-01-01,1,Tucumán,172,32,204
2018-01-01,4,Buenos Aires,4,10,14
2018-01-01,4,Capital Federal,1,3,4
2018-01-01,4,Catamarca,34,9,43
2018-01-01,4,Chaco,103,13,116
2018-01-01,4,Chubut,77,2,79
2018-01-01,4,Córdoba,737,105,842
2018-01-01,4,Corrientes,101,10,111
2018-01-01,4,Entre Ríos,222,44,266
2018-01-01,4,Formosa,45,0,45
2018-01-01,4,Jujuy,90,1,91
2018-01-01,4,La Pampa,85,268,353
2018-01-01,4,La Rioja,52,18,70
2018-01-01,4,Mendoza,205,1,206
2018-01-01,4,Misiones,116,0,116
2018-01-01,4,Neuquén,112,2,114
2018-01-01,4,Río Negro,116,915,1031
2018-01-01,4,Salta,135,1,136
2018-01-01,4,San Juan,62,564,626
2018-01-01,4,San Luis,96,291,387
2018-01-01,4,Santa Cruz,24,325,349
2018-01-01,4,Santa Fe,720,229,949
2018-01-01,4,Santiago Del Estero,89,2,91
2018-01-01,4,Tierra Del Fuego,46,544,590
2018-01-01,4,Tucumán,172,32,204
2018-01-01,3,Buenos Aires,4,11,15
2018-01-01,3,Capital Federal,1,7,8
2018-01-01,3,Catamarca,34,11,45
2018-01-01,3,Chaco,102,12,114
2018-01-01,3,Chubut,101,2,103
2018-01-01,3,Córdoba,726,94,820
2018-01-01,3,Corrientes,99,11,110
2018-01-01,3,Entre Ríos,205,48,253
2018-01-01,3,Formosa,45,0,45
2018-01-01,3,Jujuy,45,1,46
2018-01-01,3,La Pampa,83,244,327
2018-01-01,3,La Rioja,52,17,69
2018-01-01,3,Mendoza,206,1,207
2018-01-01,3,Misiones,108,0,108
2018-01-01,3,Neuquén,115,2,117
2018-01-01,3,Río Negro,112,1,113
2018-01-01,3,Salta,133,1,134
2018-01-01,3,San Juan,64,658,722
2018-01-01,3,San Luis,74,300,374
2018-01-01,3,Santa Cruz,34,434,468
2018-01-01,3,Santa Fe,695,217,912
2018-01-01,3,Santiago Del Estero,86,2,88
2018-01-01,3,Tierra Del Fuego,45,508,553
2018-01-01,3,Tucumán,171,31,202
2018-01-01,2,Buenos Aires,3,11,14
2018-01-01,2,Capital Federal,1,7,8
2018-01-01,2,Catamarca,34,11,45
2018-01-01,2,Chaco,99,12,111
2018-01-01,2,Chubut,98,2,100
2018-01-01,2,Córdoba,713,94,807
2018-01-01,2,Corrientes,98,11,109
2018-01-01,2,Entre Ríos,200,48,248
2018-01-01,2,Formosa,45,0,45
2018-01-01,2,Jujuy,45,1,46
2018-01-01,2,La Pampa,82,244,326
2018-01-01,2,La Rioja,52,17,69
2018-01-01,2,Mendoza,199,1,200
2018-01-01,2,Misiones,106,0,106
2018-01-01,2,Neuquén,114,2,116
2018-01-01,2,Río Negro,111,1,112
2018-01-01,2,Salta,134,1,135
2018-01-01,2,San Juan,63,658,721
2018-01-01,2,San Luis,21,300,321
2018-01-01,2,Santa Cruz,34,435,469
2018-01-01,2,Santa Fe,684,309,993
2018-01-01,2,Santiago Del Estero,84,2,86
2018-01-01,2,Tierra Del Fuego,44,508,552
2018-01-01,2,Tucumán,170,31,201
2018-01-01,1,Buenos Aires,3,11,14
2018-01-01,1,Capital Federal,1,7,8
2018-01-01,1,Catamarca,34,11,45
2018-01-01,1,Chaco,97,12,109
2018-01-01,1,Chubut,96,2,98
2018-01-01,1,Córdoba,714,101,815
2018-01-01,1,Corrientes,94,11,105
2018-01-01,1,Entre Ríos,197,48,245
2018-01-01,1,Formosa,32,0,32
2018-01-01,1,Jujuy,44,1,45
2018-01-01,1,La Pampa,83,396,479
2018-01-01,1,La Rioja,52,17,69
2018-01-01,1,Mendoza,199,1,200
2018-01-01,1,Misiones,104,0,104
2018-01-01,1,Neuquén,116,2,118
2018-01-01,1,Río Negro,110,1,111
2018-01-01,1,Salta,133,1,134
2018-01-01,1,San Juan,63,658,721
2018-01-01,1,San Luis,21,300,321
2018-01-01,1,Santa Cruz,34,435,469
2018-01-01,1,Santa Fe,680,309,989
2018-01-01,1,Santiago Del Estero,83,2,85
2018-01-01,1,Tierra Del Fuego,31,508,539
2018-01-01,1,Tucumán,168,31,199
2017-01-01,4,Buenos Aires,3,11,14
2017-01-01,4,Capital Federal,2,7,9
2017-01-01,4,Catamarca,30,10,40
2017-01-01,4,Chaco,97,12,109
2017-01-01,4,Chubut,91,2,93
2017-01-01,4,Córdoba,710,105,815
2017-01-01,4,Corrientes,94,11,105
2017-01-01,4,Entre Ríos,194,49,243
2017-01-01,4,Formosa,32,0,32
2017-01-01,4,Jujuy,44,1,45
2017-01-01,4,La Pampa,82,396,478
2017-01-01,4,La Rioja,52,17,69
2017-01-01,4,Mendoza,179,1,180
2017-01-01,4,Misiones,104,0,104
2017-01-01,4,Neuquén,115,2,117
2017-01-01,4,Río Negro,109,1,110
2017-01-01,4,Salta,133,1,134
2017-01-01,4,San Juan,58,659,717
2017-01-01,4,San Luis,15,300,315
2017-01-01,4,Santa Cruz,29,434,463
2017-01-01,4,Santa Fe,672,323,995
2017-01-01,4,Santiago Del Estero,69,2,71
2017-01-01,4,Tierra Del Fuego,28,508,536
2017-01-01,4,Tucumán,162,34,196
2017-01-01,3,Buenos Aires,3,11,14
2017-01-01,3,Capital Federal,2,7,9
2017-01-01,3,Catamarca,33,11,44
2017-01-01,3,Chaco,94,12,106
2017-01-01,3,Chubut,81,2,83
2017-01-01,3,Córdoba,697,108,805
2017-01-01,3,Corrientes,93,12,105
2017-01-01,3,Entre Ríos,185,50,235
2017-01-01,3,Formosa,32,0,32
2017-01-01,3,Jujuy,43,1,44
2017-01-01,3,La Pampa,79,410,489
2017-01-01,3,La Rioja,52,17,69
2017-01-01,3,Mendoza,191,2,193
2017-01-01,3,Misiones,100,0,100
2017-01-01,3,Neuquén,114,2,116
2017-01-01,3,Río Negro,106,1,107
2017-01-01,3,Salta,133,1,134
2017-01-01,3,San Juan,62,660,722
2017-01-01,3,San Luis,21,311,332
2017-01-01,3,Santa Cruz,33,468,501
2017-01-01,3,Santa Fe,662,256,918
2017-01-01,3,Santiago Del Estero,83,2,85
2017-01-01,3,Tierra Del Fuego,31,583,614
2017-01-01,3,Tucumán,161,33,194
2017-01-01,2,Buenos Aires,3,11,14
2017-01-01,2,Capital Federal,2,8,10
2017-01-01,2,Catamarca,27,13,40
2017-01-01,2,Chaco,91,14,105
2017-01-01,2,Chubut,62,2,64
2017-01-01,2,Córdoba,658,133,791
2017-01-01,2,Corrientes,90,12,102
2017-01-01,2,Entre Ríos,183,57,240
2017-01-01,2,Formosa,30,0,30
2017-01-01,2,Jujuy,43,1,44
2017-01-01,2,La Pampa,73,449,522
2017-01-01,2,La Rioja,16,18,34
2017-01-01,2,Mendoza,169,1,170
2017-01-01,2,Misiones,100,0,100
2017-01-01,2,Neuquén,115,2,117
2017-01-01,2,Río Negro,101,998,1099
2017-01-01,2,Salta,109,1,110
2017-01-01,2,San Juan,51,620,671
2017-01-01,2,San Luis,13,315,328
2017-01-01,2,Santa Cruz,26,369,395
2017-01-01,2,Santa Fe,567,362,929
2017-01-01,2,Santiago Del Estero,33,2,35
2017-01-01,2,Tierra Del Fuego,32,619,651
2017-01-01,2,Tucumán,154,37,191
2017-01-01,1,Buenos Aires,3,11,14
2017-01-01,1,Capital Federal,1,8,9
2017-01-01,1,Catamarca,26,13,39
2017-01-01,1,Chaco,89,14,103
2017-01-01,1,Chubut,62,2,64
2017-01-01,1,Córdoba,641,133,774
2017-01-01,1,Corrientes,89,12,101
2017-01-01,1,Entre Ríos,180,57,237
2017-01-01,1,Formosa,30,0,30
2017-01-01,1,Jujuy,43,1,44
2017-01-01,1,La Pampa,71,455,526
2017-01-01,1,La Rioja,16,18,34
2017-01-01,1,Mendoza,169,1,170
2017-01-01,1,Misiones,98,0,98
2017-01-01,1,Neuquén,113,2,115
2017-01-01,1,Río Negro,100,1,101
2017-01-01,1,Salta,108,1,109
2017-01-01,1,San Juan,51,620,671
2017-01-01,1,San Luis,13,315,328
2017-01-01,1,Santa Cruz,26,370,396
2017-01-01,1,Santa Fe,563,362,925
2017-01-01,1,Santiago Del Estero,34,2,36
2017-01-01,1,Tierra Del Fuego,32,619,651
2017-01-01,1,Tucumán,153,37,190
2016-01-01,4,Buenos Aires,3,11,14
2016-01-01,4,Capital Federal,1,8,9
2016-01-01,4,Catamarca,27,13,40
2016-01-01,4,Chaco,89,14,103
2016-01-01,4,Chubut,62,2,64
2016-01-01,4,Córdoba,636,133,769
2016-01-01,4,Corrientes,88,12,100
2016-01-01,4,Entre Ríos,180,57,237
2016-01-01,4,Formosa,30,0,30
2016-01-01,4,Jujuy,43,1,44
2016-01-01,4,La Pampa,71,460,531
2016-01-01,4,La Rioja,16,18,34
2016-01-01,4,Mendoza,169,1,170
2016-01-01,4,Misiones,97,0,97
2016-01-01,4,Neuquén,112,2,114
2016-01-01,4,Río Negro,100,1,101
2016-01-01,4,Salta,107,1,108
2016-01-01,4,San Juan,51,620,671
2016-01-01,4,San Luis,13,315,328
2016-01-01,4,Santa Cruz,26,370,396
2016-01-01,4,Santa Fe,561,362,923
2016-01-01,4,Santiago Del Estero,35,2,37
2016-01-01,4,Tierra Del Fuego,32,619,651
2016-01-01,4,Tucumán,152,37,189
2016-01-01,3,Buenos Aires,3,11,14
2016-01-01,3,Capital Federal,1,8,9
2016-01-01,3,Catamarca,27,13,40
2016-01-01,3,Chaco,89,14,103
2016-01-01,3,Chubut,62,2,64
2016-01-01,3,Córdoba,642,133,775
2016-01-01,3,Corrientes,88,12,100
2016-01-01,3,Entre Ríos,181,57,238
2016-01-01,3,Formosa,28,0,28
2016-01-01,3,Jujuy,43,1,44
2016-01-01,3,La Pampa,70,461,531
2016-01-01,3,La Rioja,17,18,35
2016-01-01,3,Mendoza,169,1,170
2016-01-01,3,Misiones,98,0,98
2016-01-01,3,Neuquén,110,2,112
2016-01-01,3,Río Negro,100,1,101
2016-01-01,3,Salta,108,1,109
2016-01-01,3,San Juan,51,620,671
2016-01-01,3,San Luis,13,315,328
2016-01-01,3,Santa Cruz,26,371,397
2016-01-01,3,Santa Fe,567,386,953
2016-01-01,3,Santiago Del Estero,36,2,38
2016-01-01,3,Tierra Del Fuego,31,619,650
2016-01-01,3,Tucumán,151,37,188
2016-01-01,2,Buenos Aires,3,13,16
2016-01-01,2,Capital Federal,1,10,11
2016-01-01,2,Catamarca,27,13,40
2016-01-01,2,Chaco,88,16,104
2016-01-01,2,Chubut,62,2,64
2016-01-01,2,Córdoba,635,234,869
2016-01-01,2,Corrientes,87,24,111
2016-01-01,2,Entre Ríos,178,179,357
2016-01-01,2,Formosa,29,1,30
2016-01-01,2,Jujuy,41,2,43
2016-01-01,2,La Pampa,68,485,553
2016-01-01,2,La Rioja,17,18,35
2016-01-01,2,Mendoza,169,2,171
2016-01-01,2,Misiones,96,7,103
2016-01-01,2,Neuquén,108,2,110
2016-01-01,2,Río Negro,100,1,101
2016-01-01,2,Salta,105,3,108
2016-01-01,2,San Juan,51,621,672
2016-01-01,2,San Luis,13,317,330
2016-01-01,2,Santa Cruz,26,356,382
2016-01-01,2,Santa Fe,564,607,1171
2016-01-01,2,Santiago Del Estero,37,3,40
2016-01-01,2,Tierra Del Fuego,31,619,650
2016-01-01,2,Tucumán,149,41,190
2016-01-01,1,Buenos Aires,3,13,16
2016-01-01,1,Capital Federal,1,10,11
2016-01-01,1,Catamarca,26,13,39
2016-01-01,1,Chaco,87,16,103
2016-01-01,1,Chubut,62,2,64
2016-01-01,1,Córdoba,610,234,844
2016-01-01,1,Corrientes,86,26,112
2016-01-01,1,Entre Ríos,175,179,354
2016-01-01,1,Formosa,28,1,29
2016-01-01,1,Jujuy,40,2,42
2016-01-01,1,La Pampa,65,487,552
2016-01-01,1,La Rioja,17,18,35
2016-01-01,1,Mendoza,169,2,171
2016-01-01,1,Misiones,93,7,100
2016-01-01,1,Neuquén,102,2,104
2016-01-01,1,Río Negro,99,1,100
2016-01-01,1,Salta,102,3,105
2016-01-01,1,San Juan,51,621,672
2016-01-01,1,San Luis,13,317,330
2016-01-01,1,Santa Cruz,26,356,382
2016-01-01,1,Santa Fe,551,618,1169
2016-01-01,1,Santiago Del Estero,38,3,41
2016-01-01,1,Tierra Del Fuego,30,619,649
2016-01-01,1,Tucumán,147,41,188
2015-01-01,4,Buenos Aires,3,13,16
2015-01-01,4,Capital Federal,1,10,11
2015-01-01,4,Catamarca,26,13,39
2015-01-01,4,Chaco,87,16,103
2015-01-01,4,Chubut,62,2,64
2015-01-01,4,Córdoba,626,235,861
2015-01-01,4,Corrientes,85,26,111
2015-01-01,4,Entre Ríos,174,180,354
2015-01-01,4,Formosa,28,1,29
2015-01-01,4,Jujuy,40,2,42
2015-01-01,4,La Pampa,66,312,378
2015-01-01,4,La Rioja,17,18,35
2015-01-01,4,Mendoza,169,2,171
2015-01-01,4,Misiones,93,7,100
2015-01-01,4,Neuquén,105,2,107
2015-01-01,4,Río Negro,99,1,100
2015-01-01,4,Salta,102,3,105
2015-01-01,4,San Juan,51,621,672
2015-01-01,4,San Luis,13,317,330
2015-01-01,4,Santa Cruz,26,356,382
2015-01-01,4,Santa Fe,561,627,1188
2015-01-01,4,Santiago Del Estero,39,3,42
2015-01-01,4,Tierra Del Fuego,29,619,648
2015-01-01,4,Tucumán,146,42,188
2015-01-01,3,Buenos Aires,3,13,16
2015-01-01,3,Capital Federal,1,10,11
2015-01-01,3,Catamarca,26,13,39
2015-01-01,3,Chaco,85,16,101
2015-01-01,3,Chubut,62,2,64
2015-01-01,3,Córdoba,623,237,860
2015-01-01,3,Corrientes,85,28,113
2015-01-01,3,Entre Ríos,172,182,354
2015-01-01,3,Formosa,28,1,29
2015-01-01,3,Jujuy,40,2,42
2015-01-01,3,La Pampa,65,495,560
2015-01-01,3,La Rioja,17,18,35
2015-01-01,3,Mendoza,169,2,171
2015-01-01,3,Misiones,92,7,99
2015-01-01,3,Neuquén,98,2,100
2015-01-01,3,Río Negro,99,1,100
2015-01-01,3,Salta,101,3,104
2015-01-01,3,San Juan,51,621,672
2015-01-01,3,San Luis,13,317,330
2015-01-01,3,Santa Cruz,26,359,385
2015-01-01,3,Santa Fe,556,641,1197
2015-01-01,3,Santiago Del Estero,39,3,42
2015-01-01,3,Tierra Del Fuego,33,619,652
2015-01-01,3,Tucumán,144,42,186
2015-01-01,2,Buenos Aires,3,13,16
2015-01-01,2,Capital Federal,1,10,11
2015-01-01,2,Catamarca,26,13,39
2015-01-01,2,Chaco,84,16,100
2015-01-01,2,Chubut,62,2,64
2015-01-01,2,Córdoba,610,236,846
2015-01-01,2,Corrientes,83,28,111
2015-01-01,2,Entre Ríos,169,183,352
2015-01-01,2,Formosa,27,37,64
2015-01-01,2,Jujuy,38,2,40
2015-01-01,2,La Pampa,64,500,564
2015-01-01,2,La Rioja,16,18,34
2015-01-01,2,Mendoza,169,2,171
2015-01-01,2,Misiones,89,7,96
2015-01-01,2,Neuquén,96,2,98
2015-01-01,2,Río Negro,98,1,99
2015-01-01,2,Salta,98,3,101
2015-01-01,2,San Juan,51,621,672
2015-01-01,2,San Luis,13,317,330
2015-01-01,2,Santa Cruz,25,379,404
2015-01-01,2,Santa Fe,546,649,1195
2015-01-01,2,Santiago Del Estero,39,3,42
2015-01-01,2,Tierra Del Fuego,33,619,652
2015-01-01,2,Tucumán,141,42,183
2015-01-01,1,Buenos Aires,3,15,18
2015-01-01,1,Capital Federal,1,12,13
2015-01-01,1,Catamarca,25,20,45
2015-01-01,1,Chaco,81,31,112
2015-01-01,1,Chubut,63,2,65
2015-01-01,1,Córdoba,597,294,891
2015-01-01,1,Corrientes,81,43,124
2015-01-01,1,Entre Ríos,166,231,397
2015-01-01,1,Formosa,27,43,70
2015-01-01,1,Jujuy,37,3,40
2015-01-01,1,La Pampa,62,542,604
2015-01-01,1,La Rioja,16,23,39
2015-01-01,1,Mendoza,168,2,170
2015-01-01,1,Misiones,85,7,92
2015-01-01,1,Neuquén,93,2,95
2015-01-01,1,Río Negro,96,1,97
2015-01-01,1,Salta,97,18,115
2015-01-01,1,San Juan,51,702,753
2015-01-01,1,San Luis,13,354,367
2015-01-01,1,Santa Cruz,26,424,450
2015-01-01,1,Santa Fe,536,797,1333
2015-01-01,1,Santiago Del Estero,39,8,47
2015-01-01,1,Tierra Del Fuego,33,730,763
2015-01-01,1,Tucumán,138,92,230
2014-01-01,4,Buenos Aires,3,15,18
2014-01-01,4,Capital Federal,1,12,13
2014-01-01,4,Catamarca,25,21,46
2014-01-01,4,Chaco,66,37,103
2014-01-01,4,Chubut,67,2,69
2014-01-01,4,Córdoba,590,319,909
2014-01-01,4,Corrientes,66,54,120
2014-01-01,4,Entre Ríos,141,246,387
2014-01-01,4,Formosa,26,51,77
2014-01-01,4,Jujuy,36,3,39
2014-01-01,4,La Pampa,57,567,624
2014-01-01,4,La Rioja,16,23,39
2014-01-01,4,Mendoza,168,2,170
2014-01-01,4,Misiones,77,7,84
2014-01-01,4,Neuquén,93,2,95
2014-01-01,4,Río Negro,95,1,96
2014-01-01,4,Salta,94,26,120
2014-01-01,4,San Juan,51,729,780
2014-01-01,4,San Luis,13,359,372
2014-01-01,4,Santa Cruz,25,436,461
2014-01-01,4,Santa Fe,528,938,1466
2014-01-01,4,Santiago Del Estero,39,9,48
2014-01-01,4,Tierra Del Fuego,28,741,769
2014-01-01,4,Tucumán,137,95,232
2014-01-01,3,Buenos Aires,3,14,17
2014-01-01,3,Capital Federal,1,11,12
2014-01-01,3,Catamarca,25,21,46
2014-01-01,3,Chaco,64,36,100
2014-01-01,3,Chubut,67,2,69
2014-01-01,3,Córdoba,585,200,785
2014-01-01,3,Corrientes,64,33,97
2014-01-01,3,Entre Ríos,137,115,252
2014-01-01,3,Formosa,26,64,90
2014-01-01,3,Jujuy,34,2,36
2014-01-01,3,La Pampa,62,564,626
2014-01-01,3,La Rioja,16,23,39
2014-01-01,3,Mendoza,166,2,168
2014-01-01,3,Misiones,75,0,75
2014-01-01,3,Neuquén,100,2,102
2014-01-01,3,Río Negro,97,1,98
2014-01-01,3,Salta,93,25,118
2014-01-01,3,San Juan,51,748,799
2014-01-01,3,San Luis,13,363,376
2014-01-01,3,Santa Cruz,26,446,472
2014-01-01,3,Santa Fe,520,691,1211
2014-01-01,3,Santiago Del Estero,38,9,47
2014-01-01,3,Tierra Del Fuego,28,755,783
2014-01-01,3,Tucumán,132,88,220
2014-01-01,2,Buenos Aires,3,14,17
2014-01-01,2,Capital Federal,1,11,12
2014-01-01,2,Catamarca,25,23,48
2014-01-01,2,Chaco,63,36,99
2014-01-01,2,Chubut,69,2,71
2014-01-01,2,Córdoba,577,205,782
2014-01-01,2,Corrientes,63,33,96
2014-01-01,2,Entre Ríos,135,115,250
2014-01-01,2,Formosa,26,65,91
2014-01-01,2,Jujuy,34,2,36
2014-01-01,2,La Pampa,55,580,635
2014-01-01,2,La Rioja,16,23,39
2014-01-01,2,Mendoza,165,2,167
2014-01-01,2,Misiones,75,0,75
2014-01-01,2,Neuquén,90,2,92
2014-01-01,2,Río Negro,95,1,96
2014-01-01,2,Salta,92,25,117
2014-01-01,2,San Juan,51,755,806
2014-01-01,2,San Luis,13,364,377
2014-01-01,2,Santa Cruz,27,459,486
2014-01-01,2,Santa Fe,512,605,1117
2014-01-01,2,Santiago Del Estero,38,9,47
2014-01-01,2,Tierra Del Fuego,27,766,793
2014-01-01,2,Tucumán,132,88,220
2014-01-01,1,Buenos Aires,3,14,17
2014-01-01,1,Capital Federal,1,11,12
2014-01-01,1,Catamarca,24,23,47
2014-01-01,1,Chaco,63,36,99
2014-01-01,1,Chubut,68,2,70
2014-01-01,1,Córdoba,567,205,772
2014-01-01,1,Corrientes,62,33,95
2014-01-01,1,Entre Ríos,134,115,249
2014-01-01,1,Formosa,25,87,112
2014-01-01,1,Jujuy,34,2,36
2014-01-01,1,La Pampa,54,592,646
2014-01-01,1,La Rioja,16,23,39
2014-01-01,1,Mendoza,164,2,166
2014-01-01,1,Misiones,74,0,74
2014-01-01,1,Neuquén,88,2,90
2014-01-01,1,Río Negro,94,1,95
2014-01-01,1,Salta,91,25,116
2014-01-01,1,San Juan,51,755,806
2014-01-01,1,San Luis,12,364,376
2014-01-01,1,Santa Cruz,26,460,486
2014-01-01,1,Santa Fe,506,612,1118
2014-01-01,1,Santiago Del Estero,37,9,46
2014-01-01,1,Tierra Del Fuego,27,766,793
2014-01-01,1,Tucumán,130,88,218
